##############
#....#########
#.##....######
#....##.######
#######.######
