#####################################################################################################
#...#.......#.....#.#.........#.#.........#.#.....#.#...#...#.#.#...........#...#...#.#.......#.#.#.#
###.#####.#.#.###.#.#####.#.###.###.#######.#.#####.###.#.#.#.#.#.#.#########.###.###.#.#####.#.#.#.#
#.....#...#...#.....#.....#.....#.............#.......#.#.#.....#.#.......#.#...#.#...#.#.....#.#...#
#####.#.#########.###########.#######.#.###.#.#####.#.#.#######.###.#.###.#.###.#.###.#####.#.#.#.#.#
#...#.#.#.#.....#...#...#...#.#...#...#...#.#.#.#...#...#.........#.#.#.....#...#.#...#.....#.#.#.#.#
###.#.#.#.#.#.#########.#.###.#.#####.#####.#.#.#######.#######.#.###.#.#.#####.#.#.#.###.#####.#.###
#...........#.....#.#...#.........#.....#...#.#...#.#...#...#...#.#...#.#.#.......#.#.#.....#...#...#
######.####.#####.#.#.#####.###########.###.#.#.#.#.###.###.#####.#.#.###.#.#.#.#.#.###.#####.###.###
#.........#...#...#...#.....#.......#.#.#...#...#.#.......#.....#...#.#...#.#.#.#.#.........#.#...#.#
#.###.###.#.#.#####.###.###.#.#####.#.###.#####.###.#######.###.#.#.#.###.###.#.#.#####.#####.#.#.#.#
#...#.#.#...#.#...#.#.#...#.#.....#.#.......#.#.#.....#...#...#...#.#.#.......#.#.#...#.#...#...#...#
#.#.###.#.#.###.###.#.###.#.###.#.#########.#.#####.###.#.###############.#######.###.#.###.###.###.#
#.#.#.#...#.#.....#.#...#.#...#.#.....#.#.......#.....#.#.#...#.....#...#.......#.#.......#.#...#.#.#
#.###.#.###.###.#.#.#.#######.###.#.###.#.#.###.#####.#.#####.###.#####.###.###########.###.#.###.#.#
#.#...#...#...#.#.#.....#.#.#.#.#.#...#...#.#.#.........#.#.#.#.#.#.........#.....#.#...#...#.....#.#
###.#.#.###.###.#.#.#####.#.#.#.#####.#######.#.###.#.###.#.#.#.#.###.#######.###.#.#.###.###.#.#.###
#...#.....#.....#.......#.......#.....#...........#.#.#...#.#.....#...#.....#...#.......#.#...#.#.#.#
#.#.#####.#######.#.#######.#########.###.#.#.###.###.#.#.#.#####.###.#.###.#.#####.###.#.###.#.###.#
#.#.#.#...#.....#.#.....#.#.#.#.#.#.#.....#.#.#.....#.#.#...#.....#.#.#.#.....#...#.#...#...#.#.#...#
#####.#.#######.#######.#.#.#.#.#.#.#.#############.#.#.#.#.###.#.#.#.#.###.###.#.#####.#.#.#.###.#.#
#.#.............#.....#...#.#.#...#.#.#...#.....#...#...#.#.#...#.........#.....#.#.......#.#...#.#.#
#.#.#.###.###.###.#####.###.#.#.###.#.###.#.#.#####.###.#####.###.###.#.###.###.###.#.###.#.###.#.###
#...#.#.....#.....#.#.#...#.....#.#.#.#...#.#.....#.#...#...#.#.#...#.#...#.#.....#.#.#.#.#.#.....#.#
#.#######.#######.#.#.#.###.#.#.#.#.#.#.#######.#####.#####.#.#.#######.#######.#.#####.#########.#.#
#...#...#.#.........#.......#.#...#.......#.....#...#.#.#...#.....#...#...#.#...#...#...#...#.......#
#.#.#.###.#######.#########.#############.#.###.###.#.#.#.#####.#.#.#.#####.#####.###.###.#.#####.###
#.#.....#.#.......#...#.#.....#.#...#.#.#.#.#.#.#.....#.......#.#.#.#.......#.#.........#.#.......#.#
###.#.#.###.#######.###.###.###.#.#.#.#.#.###.#.#.#.###.#.#.#####.#.###.#####.#.#######.#####.#.###.#
#...#.#...#.#.#...#...............#...#...#.......#...#.#.#.....#.#...#.....#...#...#.....#.#.#.....#
#####.###.#.#.#.#####.#.#.###.#.###.###.###########.###.#####.#.#.#.###.#####.#.###.#.#####.#.#######
#.......#.#.#.....#...#.#.#...#.#.............#...#...#.#.#...#...#.#.#.#...#.#.#.......#...#.#.....#
#######.#.###.#############.#.#.###.#############.#.#.###.#.#.#.#.#.#.#.#.#.###.###.#.#.#.#.#.###.###
#.#.#...#.......#...#.......#.#.#.#.#...#...#...#.#.#.....#.#.#.#...#.#...#.#...#...#.#.#.#.#...#...#
#.#.#.#.#####.###.#######.#####.#.#####.#.###.###.#.#.#.#########.###.#########.#########.#.###.#.###
#.#.#.#.....#.....#.#.......#.#.#.#...#.............#.#.#.....#.#.#.#...#.......#.#...#...#...#.....#
#.#.#####.#.###.#.#.#.###.###.###.#.#.###.#####.###########.#.#.#.#.###.#.#####.#.#.#.###.#.###.###.#
#.......#.#.#...#.......#.#.#.....#.#.#.#.#.....#.......#.#.#.#.....#.....#.#...#...#.....#.......#.#
#####.#.###.#.#.#.#.#######.###.###.###.#######.#.#####.#.#.#.###.###.###.#.#######.###.#########.###
#...#.#.....#.#.#.#...#.....#.#.............#.......#.#.#...#.......#...#.........#...#.#.#.#.#.#...#
###.###.###.###.#########.#.#.#####.###.#############.#.#.#########.#########.#####.#####.#.#.#.###.#
#.......#.#.#.....#.....#.#.#...#.#.#...#...#.....#...#.#.....#.............#.......#.........#.#...#
###.#####.#####.#####.###.###.###.#####.#.#.#.###.#.#.#.#####.#####.#.#.###.#.#######.###.#.###.###.#
#.....#.#.....#.......#.#...#.#.#.......#.#...#.....#...#.......#...#.#...#.#...#.....#.#.#.#.......#
#####.#.#.#.#.#.#.###.#.#.#.#.#.###.###.#.#.###.###.#.#.#################.#####.#######.#.#######.#.#
#.#.....#.#.#.#.#...#.#...#...#.#.#...#.#.#.#.....#.#.#.#.....#.#...........#.............#.#...#.#.#
#.#.#.###.#.###.#.#.#####.###.#.#.###.###.#.#####.###.###.#.###.#####.#######.#.###.#.#####.#.#####.#
#...#...#.#.....#.#.#.#.....#.#.#.....#...#.#.......#.....#.....#.......#.....#...#.#.......#.......#
#####.#.#####.###.###.###.###.#.#.###.###.###.#.#####################.#.#.#.#######.#####.#####.#.###
#.....#.#.#.#...#...#.#.....#.......#.....#.#.#.#.#.......#.#...#.#...#.#.#.#.#...#.#.#.#...#.#.#...#
#.#.###.#.#.#.###.###.###.###.#############.#.#.#.#.#######.#.#.#.#.#####.###.#.###.#.#.###.#.#.###.#
#.#...#.....#...#...#.....#.#.#.#...#.........#.....#...#.#...#.....#.....#.#.......#.......#...#.#.#
###.#.#.#.###############.#.#.#.#.###.#####.#####.###.#.#.###.#.#.###.#.###.#####.###############.#.#
#...#.#.#.....#.#...#...#...#.#.#.#...#.#.....#.......#.#.#.#.#.#...#.#...#.....#.#...#...#.........#
#.#######.###.#.###.#.#######.#.#.#.###.###.#############.#.###.###.#.###.#.###.###.#.###.#.#########
#...#.....#...#.......#.....#.#...#...#.#...#.#...#...#...#...#...#.....#.....#...#.#.#...........#.#
#.#####.#####.#####.###.###.###.#####.#.###.#.###.#.#####.###.#.#.#########.#.###.#.#####.#.#.#####.#
#.....#.#.......#.#.#.....#.#...#.......#...#.#...#.............#.#.#.#.....#.#.........#.#.#.#.#...#
#.###.#####.#.###.#.###.###.#.#.#.#####.#####.#.#.#######.#######.#.#.###.###############.###.#.#.###
#...#.....#.#.#.#...#.....#...#...#.....#...#...#.#.#.......#.........#...#...#...#.#.#...#.....#...#
#.###.#.#######.#.#####################.###.#.#####.#.###.#####.#########.###.#.###.#.#####.#.###.#.#
#...#.#.#...#...#.#.#.#.......#.....#.#.....#.......#...#.#.....#.#...#.#.#.#.............#.#.#...#.#
#########.#####.#.#.#.#.###.###.#.#.#.###.###.###.#.#.#######.###.#.###.###.#.###.####.########.#.#.#
#...#...#...#.........#.#...#...#.#.#.#...#.....#.#.#.#.#...#.....#...#.......#...#.........#.#.#.#.#
#.###.#.#.#.###.###.#.#.#########.###.#.#.#########.###.#.###.#####.###.###.#.#.###.###.#.#.#.###.###
#.....#.#.#...#.#...#.#.#.#.#...#.....#.#...#.........#.........#...#...#...#.#...#.#...#.#.....#.#.#
#.###.###.###.###.#.###.#.#.#.###.#.#####.#####.#####.###.#.###.#.###.#.#.#.#########.#######.#.#.#.#
#.#.#.......#.#...#.#...#...#.....#.......#.#.#.#...#.#...#.#.#.......#.#.#.....#.#...#...#...#...#.#
###.#.#.#.#######.#####.###.#.###.#####.#.#.#.#.#.#####.#####.#########.#######.#.#######.#######.#.#
#...#.#.#...#.....#.#...#.....#.#.#.....#.....#.......#.#.#.....#.....#.#.........#...#.#.....#.#...#
###.#.###.###.#####.###.#####.#.#.#.###.#####.###.#.###.#.#.#.#######.#.#.#.#####.###.#.#.#####.#.#.#
#.......#.......#.......#.#.....#.#.#.......#.....#.........#.#.......#.#.#...#...........#.#.....#.#
#########.#####.###.###.#.#.#####.#.#####.###########.#.###.###.#.###.#.#.#####.#######.###.#.#####.#
#.#.......#.....#...#.#.#.....#.#.#.#...#.#.....#.....#...#.....#.#.#.#.#.#.#.#.#.#.#.........#.....#
#.#.#######.#.###.###.###.###.#.###.###.#.#.#.#.#.#.###.#.###.#####.#.###.#.#.#.#.#.###.###.#######.#
#...#...#...#...#.......#.#.#...#.....#.#.#.#.#.#.#...#.#.#.#.#.....#.#...#.....#.........#.#...#...#
#.#####.###.#######.#.#.#.#.###.#.#.###.#.###.#.#####.#.#.#.#.#.#########.#####.#####.#########.#.###
#.#.......#.......#.#.#.#...#.#.#.#.#.#.#.....#...#.#.#.#.#...#.....#.#.#.#.....#.......#...#.#.....#
#####.#.###.#######.#####.###.#.#.###.#.#.###.#####.#####.#####.###.#.#.###.#####.#.#######.#.#####.#
#.....#...........#...#.....#.#.#.#.#.#...#...#.........#.#.......#...........#...#...#.......#...#.#
###.#.###.#.#######.###.###.#.###.#.#.#.###.#########.#.#####.#####.#.#.#.#######.###.###.#######.###
#.#.#.#...#.......#.#.....#.#.#.....#.....#...#.#...#.#...........#.#.#.#...#.....#...#.....#...#...#
#.###.#.#####.#.#.#.#.#####.#.#.#########.#.#.#.#.#################.#.#.###.#.#######.#.#####.#####.#
#.....#.#...#.#.#.#.......#...#.#.........#.#.............#.#.....#.#.#.#...#.#.................#...#
#####.#####.###.#.###.#.#.#######.#######.###.###.#.#######.#.###.#######.###.#####.###.#####.#.###.#
#.......#.......#.....#.#...#.#...#.......#...#.#.#...#...#.#.#...#.....#...#...#.....#...#.#.#.....#
#.#.#####.#.#######.#####.###.#.#.#.#.#######.#.###.#.#.###.#.###.#.#####.#.###.###########.#.#.#.###
#.#...#...#.#.......#.#...#...#.#.#.#...#.#...#.....#...#...#.#.#...#.....#.#.....#...#.......#.#.#.#
#########.#######.###.#######.###.#######.###.###.###.#.#.#.#.#.###.#.###.#######.###.###.#.#####.#.#
#...#.....#...............#.............#...#.#...#...#.#.#.#...#.......#.#.#.#.....#.....#...#.#...#
#.#######.#######.#######.###.#.#.#.###.###.#.#######.#.#.#####.#####.#####.#.#####.#####.#.###.#.###
#...#.....#.....#...#.......#.#.#.#.#.....#.#.#...#.#.#.....#.....#...#.#.#.#.#...#.#.#.#.#.....#...#
#.#.#.#.#.###.#.###.#.#######.#.###.#####.#.#.#.#.#.#######.###.#####.#.#.#.#.###.###.#.#####.#.#####
#.#.#.#.#...#.#.....#.....#...#.#.......#.#.....#...#...#...#.....#.#.#.......#.#.......#.....#.#...#
###.#.#####.###.#####.#.#######.###.#.#######.#####.#.#############.#######.###.#.###.#.#.#.#####.#.#
#...#...#...#.......#.#.#...#.#...#.#...#...#.#.#.#.#.........#.#...#...............#.#.#.#.....#.#.#
#.#.#.#.###.#########.###.###.#######.###.###.#.#.###.#.#.#.###.###.#########.#.#.#####.#.#.###.#.#.#
#.#...#.#.#.#.....#.....#.....#.#.........#...#...#.#.#.#.#...#.......#.....#.#.#...#.....#.#...#.#.#
#######.#.#####.#.#####.#.#####.#############.#.###.#.#####.#.#.#####.#.###.#.#.#.#.###.#.#.###.#.#.#
#.............#.#.........................#...............#.#.#.#.......#.....#.#.#.#...#.#...#.....#
##################################.##################################################################
